Note: Do not change the headings in this file, they are used to detect problems	
Status Bar Message	Tool Tip
Для помощи нажмите F1	
Создать новую Кампанию	Новая кампания
Открыть существующую кампанию	Открыть кампанию
Сохранить текущую кампанию	Сохранить кампанию
Сохранить кампанию под новым именем	Сохранить кампанию как…
Показать информацию о программе	Немного о себе.
Выйти из редактора кампаний	Выход
Лист топиков	Топики
Показать помощь по текущей команде	Помощь
Открыть кампанию	
Изменить размер окна	
Изменить положение окна	
Свернуть окно в иконку	
Раскрыть окно на максимальную ширину	
Закрыть окно	
Восстановить нормальный размер окна	
Обновить все карты сценариев в кампании	
Экспортировать все сценарии в кампанию	
Модифицировать свойства кампании	Свойства кампании
Модифицировать своиства сценария	Свойства сценария
Экспортировать текст из кампании в текстовый файл	
Вставить текст из текстового файла в кампанию	
