Сторожевой Пост	На Сторожевом Посту вы сможете нанять Копейщиков.
Башня Арбалетчиков	В Башне Арбалетчиков вы можете нанять Арбалетчиков.
Грифонова Башня	В Грифоновой Башне вы можете нанять Грифонов.
Казармы	В Казармах вы можете нанять Мечников.
Монастырь	В Монастыре вы можете нанять Монахов.
Манеж	В Манеже вы можете нанять Кавалеристов.
Портал Славы	В Портале Славы вы можете нанять Ангелов.
Ул. Сторожевой Пост	На Ул. Сторожевом Посту вы можете нанять Алебардщиков.
Ул. Башня Арбалетчиков	В Ул. Башне Арбалетчиков вы можете нанять Искусных Арбалетчиков.
Ул. Грифонова Башня	В Ул. Грифоновой Башне вы можете нанять Королевских Грифонов.
Ул. Казармы	В Ул. Казармах вы можете нанять Крестоносцев.
Ул. Монастырь	В Ул. Монастыре вы можете нанять Фанатиков.
Ул. Манеж	В Ул. Манеже вы можете нанять Чемпионов.
Ул. Портал Славы	В Ул. Портале Славы вы можете нанять Архангелов.
Конюшни Кентавров	В Конюшнях Кентавров вы можете нанять Кентавров.
Коттедж Гномов	В Коттедже Гномов вы можете нанять Гномов.
Усадьба	В Усадьбе вы можете нанять Эльфов.
Зачарованный Ручей	У Зачарованного Ручья вы можете нанять Пегасов.
Арка Дендроидов	Под Аркой Дендроидов вы можете нанять Дендроидов.
Опушка Единорогов	На Опушке Единорогов вы можете нанять Единорогов.
Драконьи Скалы	На Драконьих Скалах вы можете нанять Зелёных Драконов.
Ул. Конюшни Кентавров	В Ул. Конюшнях Кентавров вы можете нанять Капитанов Кентавров.
Ул. Коттедж Гномов	В Ул. Коттедже Гномов вы можете нанять Боевых Гномов.
Ул. Усадьба	В Ул. Усадьбе вы можете нанять Благородных Эльфов.
Ул. Зачарованный Ручей	У Ул. Зачарованного Ручья вы можете нанять Серебряных Пегасов.
Ул. Арка Дендроидов	Под Ул. Аркой Дендроидов вы можете нанять Дендроидов-Солдат.
Ул. Опушка Единорогов	На Ул. Опушке Единорогов вы можете нанять Боевых Единорогов.
Ул. Драконьи Скалы	На Ул. Драконьих Скалах вы можете нанять Золотых Драконов.
Мастерская	В Мастерской вы можете нанять Гремлинов.
Парапет	На Парапете вы можете нанять Каменных Горгулий.
Фабрика Големов	На Фабрике Големов вы можете нанять Каменных Големов.
Башня Магов	В Башне Магов вы можете нанять Магов.
Алтарь Желаний	У Алтаря Желаний вы можете нанять Джиннов.
Золотой Павильон	В Золотом Павильоне вы можете нанять Наг.
Заоблачный Храм	В Заоблачном Храме вы можете нанять Гигантов.
Ул. Мастерская	В Ул. Мастерской вы можете нанять Гремлинов-Мастеров.
Ул. Парапет	На Ул. Парапете вы можете нанять Обсидиановых Горгулий.
Ул. Фабрика Големов	На Ул. Фабрике Големов вы можете нанять Железных Големов.
Ул. Башня Магов	В Ул. Башне Магов вы можете нанять Архимагов.
Ул. Алтарь Желаний	У Ул. Алтаря Желаний вы можете нанять Верховных Джиннов.
Ул. Золотой Павильон	В Ул. Золотом Павильоне вы можете нанять Королев Наг.
Ул. Заоблачный Храм	В Ул. Заоблачном Храме вы можете нанять Титанов.
Котёл Бесов	В Котле Бесов вы можете нанять Бесов.
Чертоги Пороков	В Чертогах Пороков вы можете нанять Гогов.
Псарни	В Псарнях вы можете нанять Адских Гончих.
Врата Демонов	Во Вратах Демонов вы можете нанять Демонов.
Провал	В Провале вы можете нанять Отродий Пропасти.
Огненное Озеро	На Огненном Озере вы можете нанять Ифритов.
Покинутый Дворец	В Покинутом Дворце вы можете нанять Дьяволов.
Ул. Котёл Бесов	В Ул. Котле Бесов вы можете нанять Чертей.
Ул. Чертоги Пороков	В Ул. Чертогах Пороков вы можете нанять Магогов.
Ул. Псарни	В Ул. Псарнях вы можете нанять Церберов.
Ул. Врата Демонов	В Ул. Вратах Демонов вы можете нанять Рогатых Демонов.
Ул. Провал	В Ул. Провале вы можете нанять Властителей Пропасти.
Ул. Огненное Озеро	На Ул. Огненном Озере вы можете нанять Султанов Ифритов.
Ул. Покинутый Дворец	В Ул. Покинутом Дворце вы можете нанять Архидьяволов.
Проклятый Храм	В Проклятом Храме вы можете нанять Скелетов.
Кладбище	На Кладбище вы можете нанять Ходячих Мертвецов.
Пристанище Душ	В Пристанище Душ вы можете нанять Духов.
Поместье	В Поместье вы можете нанять Вампиров.
Мавзолей	В Мавзолее вы можете нанять Личей.
Дворец Тьмы	Во Дворце Тьмы вы можете нанять Чёрных Рыцарей.
Склеп Драконов	В Склепе Драконов вы можете нанять Костяных Драконов.
Ул. Проклятый Храм	В Ул. Проклятом Храме вы можете нанять Скелетов-Воинов.
Ул. Кладбище	На Ул. Кладбище вы можете нанять Зомби.
Ул. Пристанище Душ	В Ул. Пристанище Душ вы можете нанять Привидений.
Ул. Поместье	В Ул. Поместье вы можете нанять Лордов Вампиров.
Ул. Мавзолей	В Ул. Мавзолее вы можете нанять Могущественных Личей.
Ул. Дворец Тьмы	В Ул. Дворце Тьмы вы можете нанять Рыцарей Ужаса.
Ул. Склеп Драконов	В Ул. Склепе Драконов вы можете нанять Призрачных Драконов.
Питомник	В Питомнике вы можете нанять Троглодитов.
Гнездовье Гарпий	У Гнездовья Гарпий вы можете нанять Гарпий.
Камень Бехолдеров	У Камня Бехолдеров вы можете нанять Бехолдеров.
Зал Застывших Голосов	В Зале Застывших Голосов вы можете нанять Медуз.
Лабиринт	В Лабиринте вы можете нанять Минотавров.
Логово Мантикор	В Логове Мантикор вы можете нанять Мантикор.
Пещера Драконов	В Пещере Драконов вы можете нанять Красных Драконов.
Ул. Питомник	В Ул. Питомнике вы можете нанять Троглодитов-Охотников.
Ул. Гнездовье Гарпий	У Ул. Гнездовья Гарпий вы можете нанять Гарпий-Ведьм.
Ул. Камень Бехолдеров	У Ул. Камня Бехолдеров вы можете нанять Зловещих Глаз.
Ул. Зал Застывших Голосов	В Ул. Зале Застывших Голосов вы можете нанять Королев Медуз.
Ул. Лабиринт	В Ул. Лабиринте вы можете нанять Королей Минотавров.
Ул. Логово Мантикор	В Ул. Логове Мантикор вы можете нанять Скорпикор.
Ул. Пещера Драконов	В Ул. Пещере Драконов вы можете нанять Чёрных Драконов.
Казармы Гоблинов	В Казармах Гоблинов вы можете нанять Гоблинов.
Волчий Загон	В Волчьем Загоне вы можете нанять Наездников на Волках.
Башня Орков	В Башне Орков вы можете нанять Орков.
Форт Огров	В Форте Огров вы можете нанять Огров.
Гнездо на Скале	В Гнезде на Скале вы можете нанять Птиц Рух.
Пещера Циклопов	В Пещере Циклопов вы можете нанять Циклопов.
Утёс Чудищ	В Утёсе Чудищ вы можете нанять Чудищ.
Ул. Казармы Гоблинов	В Ул. Казармах Гоблинов вы можете нанять Хобгоблинов.
Ул. Волчий Загон	В Ул. Волчьем Загоне вы можете нанять Налётчиков.
Ул. Башня Орков	В Ул. Башне Орков вы можете нанять Вождей Орков.
Ул. Форт Огров	В Ул. Форте Огров вы можете нанять Огров-Магов.
Ул. Гнездо на Скале	В Ул. Гнезде на Скале вы можете нанять Птиц Грома.
Ул. Пещера Циклопов	В Ул. Пещере Циклопов вы можете нанять Королей Циклопов.
Ул. Утёс Чудищ	В Ул. Утёсе Чудищ вы можете нанять Древних Чудищ.
Хижина Гноллов	В Хижине Гноллов вы можете нанять Гноллов.
Шалаши Ящеров	В Шалашах Ящеров вы можете нанять Ящеров.
Улей Змиев	В Улье Змиев вы можете нанять Змиев.
Яма Василисков	В Яме Василисков вы можете нанять Василисков.
Логово Горгон	В Логове Горгон вы можете нанять Горгон.
Гнездо Виверн	В Гнезде Виверн вы можете нанять Виверн.
Пруд Гидр 	В Пруду Гидр вы можете нанять Гидр.
Ул. Хижина Гноллов	В Ул. Хижине Гноллов вы можете нанять Гноллов-Мародёров.
Ул. Шалаши Ящеров	В Ул. Шалашах Ящеров вы можете нанять Ящеров-Воинов.
Ул. Улей Змиев	В Ул. Улье Змиев вы можете нанять Ядовитых Змиев.
Ул. Яма Василисков	В Ул. Яме Василисков вы можете нанять Великих Василисков.
Ул. Логово Горгон	В Ул. Логове Горгон вы можете нанять Могучих Горгон.
Ул. Гнездо Виверн	В Ул. Гнезде Виверн вы можете нанять Виверн-Монархов.
Ул. Пруд Гидр	В Ул. Пруду Гидр вы можете нанять Гидр Хаоса.
Волшебный Фонарь	В Волшебном Фонаре вы можете нанять Пикси.
Алтарь Воздуха	У Алтаря Воздуха вы можете нанять Воздушных Элементалей.
Алтарь Воды	У Алтаря Воды вы можете нанять Водных Элементалей.
Алтарь Огня	У Алтаря Огня вы можете нанять Огненных Элементалей.
Алтарь Земли	У Алтаря Земли вы можете нанять Земляных Элементалей.
Алтарь Мысли	У Алтаре Мысля вы можете нанять Психических Элементалей.
Погребальный Костёр	У Погребального Костра вы можете нанять Огненных Птиц.
Ул. Волшебный Фонарь	В Ул. Волшебном Фонаре вы можете нанять Фей.
Ул. Алтарь Воздуха	У Ул. Алтаря Воздуха вы можете нанять Элементалей Шторма.
Ул. Алтарь Воды	У Ул. Алтаря Воды вы можете нанять Элементалей Льда.
Ул. Алтарь Огня	У Ул. Алтаря Огня вы можете нанять Элементалей Энергии.
Ул. Алтарь Земли	У Ул. Алтаря Земли вы можете нанять Элементалей Магмы.
Ул. Алтарь Мысли	У Ул. Алтаря Мысли вы можете нанять Элементалей Магии.
Ул. Погребальный Костёр	У Ул. Погребального Костра вы можете нанять Фениксов.
Жилище существ 1 уровня	Здесь можно нанять существ 1 уровня.
Жилище существ 2 уровня	Здесь можно нанять существ 2 уровня.
Жилище существ 3 уровня	Здесь можно нанять существ 3 уровня.
Жилище существ 4 уровня	Здесь можно нанять существ 4 уровня.
Жилище существ 5 уровня	Здесь можно нанять существ 5 уровня.
Жилище существ 6 уровня	Здесь можно нанять существ 6 уровня.
Жилище существ 7 уровня	Здесь можно нанять существ 7 уровня.
Ул. жилище существ 1 уровня	Здесь можно нанять ул. существ 1 уровня.
Ул. жилище существ 2 уровня	Здесь можно нанять ул. существ 2 уровня.
Ул. жилище существ 3 уровня	Здесь можно нанять ул. существ 3 уровня.
Ул. жилище существ 4 уровня	Здесь можно нанять ул. существ 4 уровня.
Ул. жилище существ 5 уровня	Здесь можно нанять ул. существ 5 уровня.
Ул. жилище существ 6 уровня	Здесь можно нанять ул. существ 6 уровня.
Ул. жилище существ 7 уровня	Здесь можно нанять ул. существ 7 уровня.
