Rollover Text	Right-Click Text																						
Note: Do not change the headings in this file, they are used to detect problems																							
Main Menu																							
	"{Новая Игра}

Начать новую игру."																						
	"{Загрузить Игру}

Загрузить сохранённую игру."																						
	"{Рекорды}

Просмотр достижений игроков, как в одиночных сценариях, так и в игровых кампаниях."																						
	"{Создатели}

Просмотреть информацию о создателях Героев III."																						
	"{Выйти}

Вернуться в Windows.
(покинуть игру)"																						
																							
New Game	New Game																						
	"{Одиночная игра}

Играть в имеющиеся сценарии или создать случайную карту для игры."																						
	"{Кампания}

Играть в Кампанию ""Рог Бездны"" или в одну из пользовательских кампаний."																						
	"{Многопользовательская игра}

Играть через Интернет, Локальную сеть, Модем, Прямое соединение или же на одном компьютере с оппонентом."																						
	"{Учебник}

Играть по учебному сценарию, демонстрирующему азы Героев III."																						
	"{Назад}

Вернуться в предыдущее меню."																						
																							
Single Scenario Selection	Single Scenario Selection																						
																							
SCENARIO_BACKGROUND 	Выбрать сценарий																						
ADVANCED_BACKGROUND 	Установить продвинутые опции																						
Background for random map menu	Сформировать и создать случайную карту																						
SCENARIO_NAME 	Имя сценария																						
Description Title	Введение в миссию сценария																						
Description text	Показывает задачи сценария																						
EASY 	"{Сложность — Легко}

Игрок начинает с большим запасом ресурсов, компьютер играет слабо."																						
NORMAL 	"{Сложность — Нормально}

Игрок начинает со средним запасом ресурсов, компьютер играет достаточно хорошо."																						
HARD 	"{Сложность — Сложно}

Игрок начинает с таким же запасом ресурсов, как и компьютер, компьютер играет на пределе своих возможностей."																						
EXPERT 	"{Сложность — Эксперт}

Игрок начинает с уменьшенным запасом ресурсов, компьютер играет на пределе своих возможностей."																						
IMPOSSIBLE 	"{Сложность — Невозможно}

Игрок начинает без запаса ресурсов, компьютер играет на пределе своих возможностей."																						
ALLY_FLAG1 	Это ваш цвет																						
ALLY_FLAG2 	Это цвет ваших союзников																						
ALLY_FLAG3 	Это цвет ваших союзников																						
ALLY_FLAG4 	Это цвет ваших союзников
ALLY_FLAG5 	Это цвет ваших союзников
ALLY_FLAG6 	Это цвет ваших союзников
ALLY_FLAG7 	Это цвет ваших союзников
ALLY_FLAG8 	Это цвет ваших союзников
ENEMY_FLAG1 	Это цвет ваших врагов
ENEMY_FLAG2 	Это цвет ваших врагов
ENEMY_FLAG3 	Это цвет ваших врагов
ENEMY_FLAG4 	Это цвет ваших врагов
ENEMY_FLAG5 	Это цвет ваших врагов
ENEMY_FLAG6 	Это цвет ваших врагов
ENEMY_FLAG7 	Это цвет ваших врагов
ENEMY_FLAG8 	Это цвет ваших врагов
SCENARIO_OPTIONS 	Показать/Спрятать список сценариев
ADVANCED_OPTIONS 	Показать/Спрятать дополнительные опции
random map button	Играть случайно созданную карту
CHAT_DESC 	Переключиться между окном миссии и окном чата
MAP_DIFFICULTY 	Это позволяет вам изменять общую сложность миссии
RATING 	Показывает общую сложность, основанную на настройках Карты и Игрока
MAP_SIZE 	Сложность карты может быть Простой, Нормальной, Сложной, Эксперт и Нереальной
VICTORY_CONDITION 	Условия победы для данного сценария
LOSS_CONDITION 	Условия поражения для данного сценария
SMALL_FILTER 	Просмотр всех маленьких карт
MEDIUM_FILTER 	Просмотр всех средних карт
LARGE_FILTER 	Просмотр всех больших карт
EXTRALARGE_FILTER 	Просмотр всех очень больших карт
ALL_FILTER 	Просмотр всех карт
SCENARIO_NAME_1 	SCENARIO_NAME_1 
SCENARIO_NAME_2 	SCENARIO_NAME_2 
SCENARIO_NAME_3 	SCENARIO_NAME_3 
SCENARIO_NAME_4 	SCENARIO_NAME_4 
SCENARIO_NAME_5 	SCENARIO_NAME_5 
SCENARIO_NAME_6 	SCENARIO_NAME_6 
SCENARIO_NAME_7 	SCENARIO_NAME_7 
SCENARIO_NAME_8 	SCENARIO_NAME_8 
SCENARIO_NAME_9 	SCENARIO_NAME_9 
SCENARIO_NAME_10 	SCENARIO_NAME_10 
SCENARIO_NAME_11 	SCENARIO_NAME_11 
SCENARIO_NAME_12 	SCENARIO_NAME_12 
SCENARIO_NAME_13 	SCENARIO_NAME_13 
SCENARIO_NAME_14 	SCENARIO_NAME_14 
SCENARIO_NAME_15 	SCENARIO_NAME_15 
SCENARIO_NAME_16 	SCENARIO_NAME_16 
SCENARIO_NAME_17 	SCENARIO_NAME_17 
SCENARIO_NAME_18 	SCENARIO_NAME_18 
ENTRY_SCENARIO_NAME_1 	ENTRY_SCENARIO_NAME_1 
ENTRY_SCENARIO_NAME_2 	ENTRY_SCENARIO_NAME_2 
ENTRY_SCENARIO_NAME_3 	ENTRY_SCENARIO_NAME_3 
ENTRY_SCENARIO_NAME_4 	ENTRY_SCENARIO_NAME_4 
ENTRY_SCENARIO_NAME_5 	ENTRY_SCENARIO_NAME_5 
ENTRY_SCENARIO_NAME_6 	ENTRY_SCENARIO_NAME_6 
ENTRY_SCENARIO_NAME_7 	ENTRY_SCENARIO_NAME_7 
ENTRY_SCENARIO_NAME_8 	ENTRY_SCENARIO_NAME_8 
ENTRY_SCENARIO_NAME_9 	ENTRY_SCENARIO_NAME_9 
ENTRY_SCENARIO_NAME_10 	ENTRY_SCENARIO_NAME_10 
ENTRY_SCENARIO_NAME_11 	ENTRY_SCENARIO_NAME_11 
ENTRY_SCENARIO_NAME_12 	ENTRY_SCENARIO_NAME_12 
ENTRY_SCENARIO_NAME_13 	ENTRY_SCENARIO_NAME_13 
ENTRY_SCENARIO_NAME_14 	ENTRY_SCENARIO_NAME_14 
ENTRY_SCENARIO_NAME_15 	ENTRY_SCENARIO_NAME_15 
ENTRY_SCENARIO_NAME_16 	ENTRY_SCENARIO_NAME_16 
ENTRY_SCENARIO_NAME_17 	ENTRY_SCENARIO_NAME_17 
ENTRY_SCENARIO_NAME_18 	ENTRY_SCENARIO_NAME_18 
TURN_DURATION 	Продолжительность хода
CHAT_TEXT 	Сообщения чата						
CHAT_ENTRY 	CHAT_ENTRY 						
CHAT_PLUG 	CHAT_PLUG 						
CHAT_PLAYER 	Игроки						
CHAT_PLAYER_SLIDER,	CHAT_PLAYER_SLIDER,						
ROLLOVER 	ROLLOVER 						
NEXT 	Сохранить выбранную игру						
BEGIN 	Начать выбранный сценарий						
BACK 	BACK 						
SSEXIT 	"Закрыть окно
(действий не было)"						
WHICHMAP 	"Размер текущей карты
(Маленькая, Средняя, Большая, Очень Большая, Огромная, Громадная, Гигантская)"						
SORT_NUMBER 	Сортировать карты по количеству игроков						
SORT_SIZE 	Сортировать карты по размеру						
k_sort_version	Сортировать карты по версиям						
SORT_ALPHA 	Сортировать карты по алфавиту						
SORT_VICTORY 	Сортировать карты по условиям победы						
SORT_LOSS 	Сортировать карты по условиям поражения
BRIEFING 	BRIEFING 
SSHERO 	SSHERO 
GOLDPIC 	GOLDPIC 
HUMAN_CPU1 	"""Человек или ИИ"" означает, что этим цветом может играть и человек, и компьютер. ""Только ИИ"" означает, что этим цветом может играть только компьютер."
HUMAN_CPU2 	"""Человек или ИИ"" означает, что этим цветом может играть и человек, и компьютер. ""Только ИИ"" означает, что этим цветом может играть только компьютер."
HUMAN_CPU3 	"""Человек или ИИ"" означает, что этим цветом может играть и человек, и компьютер. ""Только ИИ"" означает, что этим цветом может играть только компьютер."
HUMAN_CPU4 	"""Человек или ИИ"" означает, что этим цветом может играть и человек, и компьютер. ""Только ИИ"" означает, что этим цветом может играть только компьютер."
HUMAN_CPU5 	"""Человек или ИИ"" означает, что этим цветом может играть и человек, и компьютер. ""Только ИИ"" означает, что этим цветом может играть только компьютер."
HUMAN_CPU6 	"""Человек или ИИ"" означает, что этим цветом может играть и человек, и компьютер. ""Только ИИ"" означает, что этим цветом может играть только компьютер."
HUMAN_CPU7 	"""Человек или ИИ"" означает, что этим цветом может играть и человек, и компьютер. ""Только ИИ"" означает, что этим цветом может играть только компьютер."
HUMAN_CPU8 	"""Человек или ИИ"" означает, что этим цветом может играть и человек, и компьютер. ""Только ИИ"" означает, что этим цветом может играть только компьютер."
HANDICAP1 	Позволяет помешать этому игроку, уничтожая его стартовые ресурсы.
HANDICAP2 	Позволяет помешать этому игроку, уничтожая его стартовые ресурсы.
HANDICAP3 	Позволяет помешать этому игроку, уничтожая его стартовые ресурсы.
HANDICAP4 	Позволяет помешать этому игроку, уничтожая его стартовые ресурсы.
HANDICAP5 	Позволяет помешать этому игроку, уничтожая его стартовые ресурсы.
HANDICAP6 	Позволяет помешать этому игроку, уничтожая его стартовые ресурсы.
HANDICAP7 	Позволяет помешать этому игроку, уничтожая его стартовые ресурсы.
HANDICAP8 	Позволяет помешать этому игроку, уничтожая его стартовые ресурсы.
TOWN_LEFT1 	Позволяет вам выбрать тип стартового города
TOWN_LEFT2 	Позволяет вам выбрать тип стартового города
TOWN_LEFT3 	Позволяет вам выбрать тип стартового города
TOWN_LEFT4 	Позволяет вам выбрать тип стартового города
TOWN_LEFT5 	Позволяет вам выбрать тип стартового города
TOWN_LEFT6 	Позволяет вам выбрать тип стартового города
TOWN_LEFT7 	Позволяет вам выбрать тип стартового города
TOWN_LEFT8 	Позволяет вам выбрать тип стартового города
TOWN_RITE1 	Позволяет вам выбрать тип стартового города
TOWN_RITE2 	Позволяет вам выбрать тип стартового города
TOWN_RITE3 	Позволяет вам выбрать тип стартового города
TOWN_RITE4 	Позволяет вам выбрать тип стартового города
TOWN_RITE5 	Позволяет вам выбрать тип стартового города
TOWN_RITE6 	Позволяет вам выбрать тип стартового города
TOWN_RITE7 	Позволяет вам выбрать тип стартового города
TOWN_RITE8 	Позволяет вам выбрать тип стартового города
HERO_LEFT1 	Позволяет вам выбрать стартового героя, основываясь на типе города
HERO_LEFT2 	Позволяет вам выбрать стартового героя, основываясь на типе города
HERO_LEFT3 	Позволяет вам выбрать стартового героя, основываясь на типе города
HERO_LEFT4 	Позволяет вам выбрать стартового героя, основываясь на типе города
HERO_LEFT5 	Позволяет вам выбрать стартового героя, основываясь на типе города
HERO_LEFT6 	Позволяет вам выбрать стартового героя, основываясь на типе города
HERO_LEFT7 	Позволяет вам выбрать стартового героя, основываясь на типе города
HERO_LEFT8 	Позволяет вам выбрать стартового героя, основываясь на типе города
HERO_RITE1 	Позволяет вам выбрать стартового героя, основываясь на типе города
HERO_RITE2 	Позволяет вам выбрать стартового героя, основываясь на типе города
HERO_RITE3 	Позволяет вам выбрать стартового героя, основываясь на типе города
HERO_RITE4 	Позволяет вам выбрать стартового героя, основываясь на типе города
HERO_RITE5 	Позволяет вам выбрать стартового героя, основываясь на типе города
HERO_RITE6 	Позволяет вам выбрать стартового героя, основываясь на типе города
HERO_RITE7 	Позволяет вам выбрать стартового героя, основываясь на типе города
HERO_RITE8 	Позволяет вам выбрать стартового героя, основываясь на типе города
RES_LEFT1 	Позволяет выбрать стартовый бонус герою
RES_LEFT2 	Позволяет выбрать стартовый бонус герою
RES_LEFT3 	Позволяет выбрать стартовый бонус герою
RES_LEFT4 	Позволяет выбрать стартовый бонус герою
RES_LEFT5 	Позволяет выбрать стартовый бонус герою
RES_LEFT6 	Позволяет выбрать стартовый бонус герою
RES_LEFT7 	Позволяет выбрать стартовый бонус герою
RES_LEFT8 	Позволяет выбрать стартовый бонус герою
RES_RITE1 	Позволяет выбрать стартовый бонус герою
RES_RITE2 	Позволяет выбрать стартовый бонус герою
RES_RITE3 	Позволяет выбрать стартовый бонус герою
RES_RITE4 	Позволяет выбрать стартовый бонус герою
RES_RITE5 	Позволяет выбрать стартовый бонус герою
RES_RITE6 	Позволяет выбрать стартовый бонус герою
RES_RITE7 	Позволяет выбрать стартовый бонус герою
RES_RITE8 	Позволяет выбрать стартовый бонус герою
HERO_SETTING_1 	Щёлкните здесь, чтобы играть этим цветом
HERO_SETTING_2 	Щёлкните здесь, чтобы играть этим цветом
HERO_SETTING_3 	Щёлкните здесь, чтобы играть этим цветом
HERO_SETTING_4 	Щёлкните здесь, чтобы играть этим цветом
HERO_SETTING_5 	Щёлкните здесь, чтобы играть этим цветом
HERO_SETTING_6 	Щёлкните здесь, чтобы играть этим цветом
HERO_SETTING_7 	Щёлкните здесь, чтобы играть этим цветом
HERO_SETTING_8 	Щёлкните здесь, чтобы играть этим цветом
TOWN_SETTING_1 	TOWN_SETTING_1 
TOWN_SETTING_2 	TOWN_SETTING_2 
TOWN_SETTING_3 	TOWN_SETTING_3 
TOWN_SETTING_4 	TOWN_SETTING_4 
TOWN_SETTING_5 	TOWN_SETTING_5 	
TOWN_SETTING_6 	TOWN_SETTING_6 	
TOWN_SETTING_7 	TOWN_SETTING_7 	
TOWN_SETTING_8 	TOWN_SETTING_8 	
const_create_map,		
const_map_size_label,	Выберите размер карты	
const_small_map,	Создать маленькую карту	
const_medium_map,	Создать среднюю карту	
const_large_map,	Создать большую карту	
const_huge_map,	Создать очень большую карту	
const_map_levels,	Выберите одно- или двухуровневую карту	
const_human_positions_label,	Выберите число человеко-играбельных позиций	
const_1_human,	Создать 1 игрока-пользователя	
const_2_humans,	Создать 2 игроков-пользователей	
const_3_humans,	Создать 3 игроков-пользователей	
const_4_humans,	Создать 4 игроков-пользователей	
const_5_humans,	Создать 5 игроков-пользователей	
const_6_humans,	Создать 6 игроков-пользователей	
const_7_humans,	Создать 7 игроков-пользователей	
const_8_humans,	Создать 8 игроков-пользователей	
const_random_humans,	Создать от 1 до 8 игроков-пользователей	
const_human_teams_label,	Выбрать число команд для человеко-играбельных позиций	
const_no_human_teams,	Нет команд	
const_1_human_team,	Создать 1 команду людей	
const_2_human_teams,	Создать 2 команды людей	
const_3_human_teams,	Создать 3 команды людей	
const_4_human_teams,	Создать 4 команды людей	
const_5_human_teams,	Создать 5 команд людей	
const_6_human_teams,	Создать 6 команд людей	
const_7_human_teams,	Создать 7 команд людей	
const_random_human_teams,	Создать произвольное число команд пользователя	
const_computer_positions_label,	Выберите число "Только ИИ"-позиций	
const_no_computers,	Не создавать компьютерных игроков	
const_1_computer,	Создать 1 позицию "Только ИИ"	
const_2_computers,	Создать 2 позиции "Только ИИ"	
const_3_computers,	Создать 3 позиции "Только ИИ"	
const_4_computers,	Создать 4 позиции "Только ИИ"	
const_5_computers,	Создать 5 позиций "Только ИИ"	
const_6_computers,	Создать 6 позиций "Только ИИ"	
const_7_computers,	Создать 7 позиций "Только ИИ"	
const_random_computers,	Создать случайное количество позиций "Только ИИ"	
const_computer_teams_label,	Выберите число команд ИИ	
const_no_computer_teams,	Нет команд ИИ	
const_1_computer_team,	Создать 1 команду ИИ	
const_2_computer_teams,	Создать 2 команды ИИ	
const_3_computer_teams,	Создать 3 команды ИИ	
const_4_computer_teams,	Создать 4 команды ИИ	
const_5_computer_teams,	Создать 5 команд ИИ	
const_6_computer_teams,	Создать 6 команд ИИ	
const_random_computer_teams,	Создать случайное число команд ИИ	
const_water_label,	Выберите количество воды на карте	
const_no_water,	Минимум или нет воды	
const_normal_water,	Создать континент, окружённый водой	
const_islands,	Создать много маленьких островов, окружённых водой	
const_random_water,	Выбрать случайное количество воды	
const_monster_strength_label,	Выбрать относительно сильных охраняющих монстров	
const_weak_monsters,	Сделать монстров слабее, чем обычно	
const_normal_monsters,	Обычные монстры	
const_strong_monsters,	Создать сильных стражей	
const_random_monsters,	Выбрать случайную общую силу охраняющих монстров	
const_show_saved_random_maps,	Показать недавно сгенерированные карты	
SLIDER_CHATWINDOW 	Прокрутка текста чата	
SLIDER_FILEMENU 	Прокрутка списка карт или сохранённых игр	
SLIDER_DURATION 	Позволяет изменить продолжительность хода	
PLAYER_HANDICAP_HEADER_ID,	"{Имя игрока / Тип помехи}

Каждая ячейка, которую может занять игрок, помечена значком. Для того, чтобы изменить позицию, щёлкните по значку. Также можно щёлкнуть по имени, для того чтобы изменить его.

Каждому игроку можно ""помешать"". Для этого нужно нажать на кнопку ""помеха"". Всего три уровня: нет помехи, средняя помеха и большая помеха. Средняя и большая помехи уменьшают стартовые ресурсы.
"																						
TURN_DURATION_HEADER_ID,	"{Продолжительность Хода}

Пользуясь линейкой, можно установить ""мягкий"" режим ходов. При этом, во время битвы таймер останавливается, а в остальное время таймер отсчитывает время.

Продолжительность Цикла может быть 1, 2, 4, 6, 8, 10, 15, 20, 25, и 30 минут.
'Неограниченно' стоит по умолчанию.
"																						
STARTING_TOWN_HEADER_ID,	"{Исходный Город}

Каждый игрок может иметь возможность выбрать стартовый город. Можно выбрать из случайного, Замка, Оплота, Башни, Инферно, Некрополиса, Темницы, Цитадели и Крепости.

Выбор стартового города также влияет на класс стартового героя.
"																						
STARTING_TOWN_HEADER_W_CONFLUX_ID,	"{Исходный Город}

Каждый игрок может иметь возможность выбрать стартовый город. Можно выбрать из случайного, Замка, Оплота, Башни, Инферно, Некрополиса, Темницы, Цитадели, Крепости, Сопряжения и Причала.

Выбор стартового города также влияет на класс стартового героя.
"																						
STARTING_HERO_HEADER_ID,	"{Исходный Герой}

Каждый игрок может или не может начинать с героем. Иногда эта опция может отсутствовать или быть выключенной. В остальное время на ваш выбор предлагается до 16 героев. Если включена опция ""Исходный Город"", вы можете выбирать класс героя из предоставляемых вам на выбор.

Чтобы посмотреть имя героя, его класс и в чём он специализируется, щёлкните правой кнопкой мыши по его портрету."																						
STARTING_BONUS_HEADER_ID,	"{Стартовый Бонус}

Стартовый Бонус позволяет выбрать случайный артефакт, 500-1000 золотых или 5-10 единиц дерева или руды."																						
																							
Multiplayer Selection	Multiplayer Selection																						
																							
Online Service	"{Сервис он-лайн}

Позволяет играть он-лайн"																						
Горячий Стул	"{Хот сит}

Позволяет нескольким игрокам играть за одним компьютером"																						
IPX	"{IPX}

Позволяет нескольким игрокам играть в локальной сети"																						
TCP/IP	"{TCP/IP}

Позволяет нескольким игрокам играть в локальной сети или через internet"																						
Модем	"{Модем}

Позволяет двум игрокам соединяться по модему"																						
Direct Connect	"{Прямое подключение}

Позволяет двум игрокам подключаться через 0-модем"																						
Сервер	"{Сервер}

Позволяет устанавливать и создавать игру, к которой могут подключаться остальные"																						
Войти в игру	"{Подключиться}

Показывает список игр, к которым можно подключиться"
Найти игры	"{Искать игру}

Позволяет ввести IP-адрес, к которому нужно подключиться"
GAMENAME 1	GAMENAME 1
GAMENAME 2	GAMENAME 2
GAMENAME 3	GAMENAME 3
GAMENAME 4	GAMENAME 4
GAMENAME 5	GAMENAME 5
GAMENAME 6	GAMENAME 6
GAMENAME 7	GAMENAME 7
GAMENAME 8	GAMENAME 8
GAMENAME 9	GAMENAME 9
GAMENAME 10	GAMENAME 10
GAMENAME 11	GAMENAME 11
GAMENAME 12	GAMENAME 12
Пролистать список игр	Список доступных игр
	
Отмена	Вернуться в предыдущий экран																						
																							
Adventure Map Window																							
Карта Мира	Это уменьшенный вид на Мир. Щёлкнув по любому месту на карте, можно переключить карту в это место, а можно перемещать прямоугольник по карте для перемещения Карты Приключений																						
Окно Состояния	Окно Состояния																						
Обзор Королевства	"{Вид на Королевство}

Показывает города и героев Королевства."																						
Поверхность/Подземный Мир	"{Наземный/Подземный вид}

Переключает карту приключений между уровнями."																						
Журнал	"{Журнал}

Показывает список выданных заданий."																						
Усыпить/Разбудить Героя	"{Усыпить/разбудить героя}

Усыпляет выбранного героя или пробуждает спящего. Все спящие герои игнорируются кнопкой ""Следующий герой"""																						
Переместить Героя	"{Переместить героя}

Перемещает текущего героя в выбранное место."																						
Сотворить Заклинание	"{Сотворить заклинание}

Сотворить глобальное заклинание"																						
Опции Приключений	"{Опции приключений}

Позволяют раскапывать Грааль, просматривать карту-загадку, карту мира и информацию о сценарии. В многопользовательских играх можно просматривать последний ход оппонента."																						
Системные Опции	"{Системные опции}

Позволяет просматривать и менять текущие настройки игры."																						
Следующий Герой	"{Следующий герой}

Выделяет следующего героя, у которого ещё остались единицы перемещения. Все спящие герои игнорируются."																						
Закончить ход	"{Закончить ход}

Заканчивает текущий ход"																						
Список Героев	"{Список героев}

Просмотреть список доступных героев"																						
Список Героев	"{Список героев}

Просмотреть список доступных героев"																						
Портрет Героя	"{Портрет героя}

Первый щелчок выделяет героя и перемещает карту к нему. Второй щелчок выводит информацию о герое."																						
Список Городов	"{Список городов}

Просмотреть список доступных городов"																						
Список Городов	"{Список городов}

Просмотреть список доступных городов"																						
Вид Города	"{Вид города}

Первый щелчок выделяет город и перемещает карту к нему. Второй щелчок выводит информацию о городе."																						
Золото	Количество золота в вашей сокровищнице																						
Дерево	Общий запас дерева																						
Ртуть	Общий запас ртути																						
Руда	Общий запас руды																						
Сера	Общий запас серы																						
Кристаллы	Общий запас кристаллов																						
Драгоценные камни	Общий запас драгоценных камней																						
Дата	"{Дата}

Текущий месяц, неделя и день"																						
ROLLOVER	ROLLOVER																						
																							
System Options	System Options																						
Основное Меню	"{Главное меню}

Прервать игру и вернуться в главное меню"
Загрузить Игру	"{Загрузить игру}

Загрузить Игру"
Сохранить Игру	"{Сохранить игру}

Сохранить текущую игру"
Переиграть Сценарий	"{Начать заново}

Начать текущую игру заново"
Выход из игры	"{Выход из игры}

Выйти из
Героев Меча и Магии III"
Вернуться	"{Вернуться в игру}

Вернуться на карту приключений!"
MUSIC_VOLUME_0_ID,	Выключить музыку
MUSIC_VOLUME_1_ID,	Установить громкость музыки на 1
MUSIC_VOLUME_2_ID,	Установить громкость музыки на 2
MUSIC_VOLUME_3_ID,	Установить громкость музыки на 3
MUSIC_VOLUME_4_ID,	Установить громкость музыки на 4
MUSIC_VOLUME_5_ID,	Установить громкость музыки на 5
MUSIC_VOLUME_6_ID,	Установить громкость музыки на 6
MUSIC_VOLUME_7_ID,	Установить громкость музыки на 7
MUSIC_VOLUME_8_ID,	Установить громкость музыки на 8
MUSIC_VOLUME_9_ID,	Установить громкость музыки на 9
EFFECTS_VOLUME_0_ID,	Выключить звуковые эффекты
EFFECTS_VOLUME_1_ID,	Установить громкость звуковых эффектов на 1
EFFECTS_VOLUME_2_ID,	Установить громкость звуковых эффектов на 2
EFFECTS_VOLUME_3_ID,	Установить громкость звуковых эффектов на 3
EFFECTS_VOLUME_4_ID,	Установить громкость звуковых эффектов на 4
EFFECTS_VOLUME_5_ID,	Установить громкость звуковых эффектов на 5
EFFECTS_VOLUME_6_ID,	Установить громкость звуковых эффектов на 6
EFFECTS_VOLUME_7_ID,	Установить громкость звуковых эффектов на 7
EFFECTS_VOLUME_8_ID,	Установить громкость звуковых эффектов на 8
EFFECTS_VOLUME_9_ID,	Установить громкость звуковых эффектов на 9
MUSIC_TYPE_NONE_ID,	MUSIC_TYPE_NONE_ID,
MUSIC_TYPE_CD_ID,	MUSIC_TYPE_CD_ID,
MUSIC_TYPE_MIDI_ID,	MUSIC_TYPE_MIDI_ID,
HERO_SPEED_WALK_ID,	"Установить прогулочную скорость движения героя 
(самая медленная)"
HERO_SPEED_CANTER_ID,	Установить скорость движения героя на рысь
HERO_SPEED_GALLOP_ID,	Установить скорость движения героя на галоп
HERO_SPEED_JUMP_ID,	"Установить скорость передвижения героя на прыжки 
(без анимации — самая быстрая)"
AI_SPEED_CANTER_ID,	"Установить скорость передвижения противника на рысь
(самая медленная)"
AI_SPEED_GALLOP_ID,	Установить скорость передвижения противника на галоп
AI_SPEED_JUMP_ID,	"Установить скорость передвижения противника на прыжки 
(без анимации — самая быстрая)"
AI_SPEED_NONE_ID,	Не показывать передвижения противника
WINDOW_SCROLL_SLOW,	Установить низкую скорость прокрутки экрана
WINDOW_SCROLL_MEDIUM,	Установить среднюю скорость прокрутки экрана
WINDOW_SCROLL_FAST,	Установить высокую скорость прокрутки экрана
SHOW_PATH_ID,	"{Показывать путь Героя}

Показывать путь Героя без перемещения самого Героя."
MOVE_REMINDER_ID,	"{Напоминать о запасе хода}

Спрашивать подтверждение конца хода, если хотя бы у одного героя остался запас хода."
QUICK_COMBAT_ID,	"{Быстрая битва}

Эта опция позволяет компьютеру просчитать исход битвы, и играющий увидит лишь информацию о её исходе."
VIDEO_SUBTITLES_ID,	"{Субтитры}

Показывать субтитры ко всем анимированным заставкам."
VIDEO_QUALITY_LOW	"{Низкое качество видео}

Рекомендовано для слабых компьютеров, у которых возникают проблемы при проигрывании полноэкранного видео."
VIDEO_QUALITY_HIGH	"{Высокое качество видео}

Рекомендовано для мощных компьютеров, которые могут проигрывать полноэкранное видео высокого качества."
TOWN_OUTLINES_ID,	"{Контуры городских зданий}

Выделять здания в окне города при наведении мышкой."
ANIMATE_SPELLBOOK_ID,	"{Анимация книги заклинаний}

В Книге Заклинаний будут переворачиваться странички."
																							
Adventure Options																							
Посмотреть Мир	"{Просмотреть Мир}

Увидеть Мир с высоты птичьего полёта"																						
Посмотреть Карту-загадку	"{Просмотреть Карту-загадку}

Просмотр Карты с потерянным Граалем"																						
Посмотреть Информацию о Сценарии	"{Просмотреть Информацию о Сценарии}

Просмотр информации о текущем Сценарии"																						
Копать	"{Копать}

Вести раскопки потерянного Грааля"																						
Повторить Ход Оппонента	"{Повторить Ход Оппонента}

Повторяет события с вашего последнего хода"																						
ROLLOVER	ROLLOVER																						
Ок	"{Ок}

Вернуться к Карте Приключений"																						
																							
Combat Window	Combat Window																						
Капитулировать	"{Капитулировать}

Капитулировать перед врагом. Ваш герой должен будет заплатить врагу, чтобы покинуть поле брани, но он может быть незамедлительно нанят в таверне со всеми оставшимися войсками и со своими артефактами."																						
Отступить	"{Отступить}

Ваш герой сбежит с поля боя, но он может быть незамедлительно нанят в таверне со своими артефактами."																						
Настройки Битвы	"{Настройки битвы}

Позволяет просматривать и менять текущие настройки битвы"																						
Автоматическая Битва	"{Автоматическая битва}

Компьютер берёт ведение боя на себя. Вы можете вернуть себе контроль над ходом сражения, щёлкнув мышкой по экрану. Вы сможете контролировать следующее движение ваших войск."																						
	Текст сражения появляется в этом окне																						
	Просматривать текст, появляющийся во время битвы																						
Сотворить Заклинание	"{Сотворить заклинание}

Открывает Книгу Заклинаний, позволяя вашему герою сотворить заклинание"																						
Ждать	"{Ждать}

Пропустить ход подразделения, до тех пор, пока остальные войска не продвинутся"																						
Защищаться	"{Защищаться}

Увеличивает защиту отдельного юнита, принося в жертву этот ход"																						
Ожидание тактической Фазы	Ожидание тактической Фазы																						
Окончание тактической Фазы	"{Окончание тактической фазы}

Оканчивает тактическую фазу и начинает битву."																						
																							
Combat Options	Combat Options																						
Вернуться в битву	"{Вернуться в битву}

Выйти из настроек битвы."																						
Сбросить установки	"{Сбросить установки}

Восстановить настройки битвы по умолчанию."																						
MUSIC_VOLUME_0_ID,	Выключить музыку																						
MUSIC_VOLUME_1_ID,	Установить громкость музыки на 1																						
MUSIC_VOLUME_2_ID,	Установить громкость музыки на 2																						
MUSIC_VOLUME_3_ID,	Установить громкость музыки на 3																						
MUSIC_VOLUME_4_ID,	Установить громкость музыки на 4																						
MUSIC_VOLUME_5_ID,	Установить громкость музыки на 5																						
MUSIC_VOLUME_6_ID,	Установить громкость музыки на 6
MUSIC_VOLUME_7_ID,	Установить громкость музыки на 7
MUSIC_VOLUME_8_ID,	Установить громкость музыки на 8
MUSIC_VOLUME_9_ID,	Установить громкость музыки на 9
EFFECTS_VOLUME_0_ID,	Выключить звуковые эффекты
EFFECTS_VOLUME_1_ID,	Установить громкость звуковых эффектов на 1
EFFECTS_VOLUME_2_ID,	Установить громкость звуковых эффектов на 2
EFFECTS_VOLUME_3_ID,	Установить громкость звуковых эффектов на 3
EFFECTS_VOLUME_4_ID,	Установить громкость звуковых эффектов на 4
EFFECTS_VOLUME_5_ID,	Установить громкость звуковых эффектов на 5
EFFECTS_VOLUME_6_ID,	Установить громкость звуковых эффектов на 6
EFFECTS_VOLUME_7_ID,	Установить громкость звуковых эффектов на 7
EFFECTS_VOLUME_8_ID,	Установить громкость звуковых эффектов на 8
EFFECTS_VOLUME_9_ID,	Установить громкость звуковых эффектов на 9
MUSIC_TYPE_NONE_ID,	MUSIC_TYPE_NONE_ID,
MUSIC_TYPE_CD_ID,	MUSIC_TYPE_CD_ID,
MUSIC_TYPE_MIDI_ID,	MUSIC_TYPE_MIDI_ID,
AUTO_CREATURES_ID,	"{Существа}

Передаёт контроль над юнитами компьютеру"
AUTO_SPELLS_ID,	"{Заклинания}

Во время автоматической битвы ваш герой будет творить заклинания"
AUTO_CATAPULT_ID,	"{Катапульта}

При приближении к стенам противника, ваши катапульты будут сами выбирать свою цель. Если ваш баллистический навык достаточно высок, вы сможете сами управлять катапультой.

Во время автоматической битвы, если у вашего героя есть баллистический навык, эта опция передаёт управление компьютеру. "
AUTO_BALLISTA_ID,	"{Атакующая боевая машина}

Во время битвы ваши атакующие боевые машины будут сами выбирать свою цель. Если ваш артиллерийский навык достаточно высок, вы сможете управлять атакующей боевой машиной.

Во время автоматической битвы, если у вашего героя есть артиллерийский навык, управление атакующими боевыми машинами передаётся компьютеру."
AUTO_FIRST_AID_TENT_ID,	"{Палатка Первой Помощи}

Во время битвы, ваша Палатка Первой Помощи будет сама определять нуждающихся в помощи. Если ваши навыки первой помощи достаточно высоки, вы сможете сами выбирать пациентов.

Во время автоматической битвы, если у вашего героя есть навык первой помощи, эта опция передаёт управление компьютеру."
ANIMATION_SPEED_0_ID,	Установить скорость анимации на "медленно"
ANIMATION_SPEED_1_ID,	Установить скорость анимации на "нормально"
ANIMATION_SPEED_2_ID,	Установить скорость анимации на "быстро"
CREATURE_INFO_STATS_ID,	"{Вся статистика}

Щелчок правой кнопки по юниту показывает всю статистику и все заклинания, действующие в настоящий момент."
CREATURE_INFO_SPELLS_ID,	"{Только заклинания}

Щелчок правой кнопки по юниту показывает все заклинания, действующие в настоящий момент."
VIEW_HEX_ID,	"{Показать шестиугольную сетку}

Показывает шестиугольную сетку, наложенную на поле битвы."
MOVEMENT_SHADOW_ID,	"{Затенять ходы}

Затеняет участки на поле битвы, куда может переместиться герой."
SHADOW_CURSOR_ID,	"{Затенять курсор}

Затенять шестиугольник, находящийся в данный момент под курсором."
ANIMATE_SPELLBOOK_ID,	"{Анимированная Книга Заклинаний}

В Книге Заклинаний будут переворачиваться странички."
	
View Army	View Army																						
Имя Существа	Имя Существа																						
Количество Существ	Количество Существ																						
Навык Атаки	Навык Атаки																						
Навык Защиты	Навык Защиты																						
Осталось Выстрелов	Количество оставшихся выстрелов																						
Урон при Атаке	Урон при Атаке																						
Единицы здоровья	Единицы здоровья																						
Оставшиеся единицы здоровья	Оставшиеся единицы здоровья																						
Скорость	Скорость																						
Боевой Дух	Боевой Дух																						
Удача	Удача																						
Заклинания, воздействующие на войско	Заклятия, воздействующие на армию																						
Уволить Существо	"{Уволить Существо}

Уволить выделенное существо из армии"																						
Улучшить	"{Улучшить Существо}

Улучшает выделенное существо"																						
Ок	"{Ок}

Вернуться в предыдущее окно"																						
																							
Spell Book	Spell Book																						
Предыдущая Страница	Перейти к предыдущей странице																						
Следующая Страница	Перейти к следующей странице																						
Глобальные Заклинания	Перейти к странице заклинаний карты приключений																						
Боевые Заклинания	Перейти к странице заклинаний битвы																						
Заклинания Воздуха	Перейти к странице заклинаний воздуха																						
Заклинания Огня	Перейти к странице заклинаний огня																						
Заклинания Воды	Перейти к странице заклинаний воды																						
Заклинания Земли	Перейти к странице заклинаний земли																						
Все Заклинания	Показать все школы заклинаний																						
Мана	Оставшаяся Мана героя																						
Выход	Закрыть Книгу Заклинаний																						
																							
CampaignBrief	CampaignBrief																						
																							
CAMPAIGN_NAME	CAMPAIGN_NAME
CAMPAIGN_DESCRIPTION	CAMPAIGN_DESCRIPTION
MAP_NAME	MAP_NAME
MAP_DESCRIPTION	MAP_DESCRIPTION
HERO_FACE	HERO_FACE
Сменить Героя	Щёлкнув мышью, вы поменяете исходного героя
Сменить Героя	Щёлкнув мышью, вы поменяете исходного героя
Начать с Артефактом	Начать с артефактом
Начать с Золота	Начать с дополнительными золотыми
Начать с Ресурсами	Начать с дополнительными ресурсами
Переиграть	"{Начать заново}

Начать кампанию заново"
Посмотреть информацию о Кампании	"{Посмотреть введение в кампанию}

Показать вступительную заставку к кампании"
ALLY_FLAG1_ID	Это ваш цвет
ALLY_FLAG2_ID	Это цвет ваших союзников
ALLY_FLAG3_ID	Это цвет ваших союзников
ALLY_FLAG4_ID	Это цвет ваших союзников
ALLY_FLAG5_ID	Это цвет ваших союзников
ALLY_FLAG6_ID	Это цвет ваших союзников
ALLY_FLAG7_ID	Это цвет ваших союзников
ALLY_FLAG8_ID	Это цвет ваших союзников
ENEMY_FLAG1_ID	Это цвет ваших противников
ENEMY_FLAG2_ID	Это цвет ваших противников
ENEMY_FLAG3_ID	Это цвет ваших противников
ENEMY_FLAG4_ID	Это цвет ваших противников
ENEMY_FLAG5_ID	Это цвет ваших противников
ENEMY_FLAG6_ID	Это цвет ваших противников
ENEMY_FLAG7_ID	Это цвет ваших противников
ENEMY_FLAG8_ID	Это цвет ваших противников
WHICHMAP_ID	Это размер карты, на которой вы собираетесь играть
MAP_AREA_1	MAP_AREA_1
MAP_AREA_2	MAP_AREA_2
MAP_AREA_3	MAP_AREA_3
MAP_AREA_4	MAP_AREA_4
MAP_AREA_5	MAP_AREA_5
MAP_AREA_6	MAP_AREA_6
MAP_AREA_7	MAP_AREA_7
MAP_AREA_8	MAP_AREA_8
MAP_AREA_9	MAP_AREA_9
MAP_AREA_10	MAP_AREA_10
MAP_AREA_11	MAP_AREA_11
MAP_AREA_12	MAP_AREA_12
MAP_AREA_13	MAP_AREA_13
MAP_AREA_14	MAP_AREA_14
MAP_AREA_15	MAP_AREA_15
MAP_AREA_16	MAP_AREA_16
MAP_AREA_17	MAP_AREA_17
MAP_AREA_18	MAP_AREA_18
MAP_AREA_19	MAP_AREA_19
MAP_AREA_20	MAP_AREA_20																						
MAP_AREA_21	MAP_AREA_21																						
MAP_AREA_22	MAP_AREA_22																						
MAP_AREA_23	MAP_AREA_23																						
MAP_AREA_24	MAP_AREA_24																						
MAP_AREA_25	MAP_AREA_25																						
MAP_AREA_26	MAP_AREA_26																						
MAP_AREA_27	MAP_AREA_27																						
MAP_AREA_28	MAP_AREA_28																						
MAP_AREA_29	MAP_AREA_29																						
MAP_AREA_30	MAP_AREA_30																						
MAP_AREA_31	MAP_AREA_31																						
MAP_AREA_32	MAP_AREA_32																						
																							
CampaignWindow	CampaignWindow																						
																							
Долгую Жизнь Королеве!	Долгую Жизнь Королеве!		
Освобождение	Освобождение		
Жертвы Войны	Жертвы Войны		
Песня для Отца	Песня для Отца		
Подземелья и Дьяволы	Подземелья и Дьяволы		
Долгую Жизнь Королю!	Долгую Жизнь Королю!		
Семена Недовольства	Семена Недовольства		
Клинок Армагеддона	Клинок Армагеддона		
Кровь Дракона	Кровь Дракона		
Убийца Драконов	Убийца Драконов		
Праздник Жизни	Праздник Жизни		
Безрассудное Упрямство	Безрассудное Упрямство		
Игры с огнём	Игры с огнём		
Рог Бездны	Рог Бездны		
Рождение варвара	Рождение варвара		
Под Весёлым Роджером	Под Весёлым Роджером		
Гроза Морей	Гроза Морей																						
Восхождение некроманта	Восхождение некроманта																						
Нечистый альянс	Нечистый альянс																						
Призрак жизни	Призрак жизни																						
																							
																							
ROLLOVER	ROLLOVER																						
																							
Recruit	Recruit																						
Максимум																							
Нанять																							
Отмена																							
																							
Multiplayer	Multiplayer																						
Галочка	Включить/выключить имя																						
Ввести имя игрока	Ввести имя игрока																						
Ок																							
Назад																							
Ввести имя сессии																							
Ввести пароль																							
Имя Сессии																							
Ввести IP-адрес																							
																							
Sacrifice Window	Sacrifice Window																						
Выход (без жертв).	Покинуть Алтарь. Все предметы, находящиеся на Алтаре, вернутся к вам.																						
Держать артефакт																							
Положить все артефакты из рюкзака на Алтарь	Положить все артефакты из рюкзака на Алтарь																						
Положить все артефакты на Алтарь	Положить все артефакты и снаряжение из рюкзака на Алтарь																						
Принести в жертву существ	Переключиться на экран приношения существ в жертву. Доступно только злым и нейтральным героям.																						
Количество существ/Уровень опыта																							
Выбранные существа																							
Количество существ/Уровень опыта																							
Количество существ для жертвоприношения																							
Установить количество существ для жертвоприношения																							
Принести в жертву максимальное количество существ	Принести в жертву максимальное количество существ																						
Принести всех существ из армии героя в жертву	Принести в жертву всех до одного																						
Принести в жертву артефакты	Переключиться на экран приношения артефактов в жертву. Доступно только добрым и нейтральным героям.																						
Количество артефактов/Уровень опыта																							
Положить артефакт для жертвоприношения здесь																							
Уровень опыта за артефакт																							
Принести в жертву артефакты	Принести в жертву всё, что находится на Алтаре, и получить опыт																						
Принести в жертву существа	Принести в жертву всё, что находится на Алтаре, и получить опыт																						
	Порыться в рюкзаке																						
	Порыться в рюкзаке																						
																							
Skeleton Transformer	Skeleton Transformer																						
Поместить всех существ в преобразователь	Поместить всех существ в преобразователь																						
Оживить создания в преобразователе	Оживить создания в преобразователе																						
Покинуть преобразователь	Покинуть преобразователь. Больше никого оживить нельзя																						
																							
Trade Window	Trade Window																						
Совершить сделку																							
Максимум																							
Отправить ресурсы другому игроку																							
Купить артефакты																							
Продать существ																							
Выход																							
																							
Give Resource Window	Give Resource Window																						
Отправить ресурсы																							
Максимум																							
Торговать ресурсами																							
Купить артефакты																							
Выход																							
																							
Buy Artifact Window	Buy Artifact Window																						
Совершить сделку																							
Торговать ресурсами																							
Отправить ресурсы другому игроку																							
Продать артефакты																							
Выход																							
																							
Sell Artifact Window	Sell Artifact Window																						
Совершить сделку																							
Торговать ресурсами																							
Отправить ресурсы другому игроку																							
Купить артефакты																							
Выход																							
																							
Sell Creature Window	Sell Creature Window																						
Совершить сделку																							
Максимум																							
Торговать ресурсами																							
Отправить ресурсы другому игроку																							
Выход																							
																							
University Window	University Window																						
Отмена	Вернуться к выбору навыков																						
Покинуть университет	Покинуть университет																						
	Научить %s %s за %d золотых.																						
Not used... filthy bug.																							
Insert all data before this line. Do not alter or delete this line.																							



																							
