Note: Do not change the headings in this file, they are used to detect problems	
Status Bar Message	Tool Tip
Для вызова экрана Помощь нажмите F1	
Создать новую карту	Новая Карта
Открыть существующую карту	Открыть карту
Записать текущую карту	Сохранить карту
Записать текущую карту с новым именем	Сохранить карту как
Вывести информацию о программе, номер версии и права.	О игре
Выйти из редактора карт	Выход
Вывести темы для Помощи	Темы для Помощи
Вывести помощь по данной команде или данному заданию	Помощь
Открыть эту карту	
Скопировать выделенный объект и поместить его в Буфер Обмена (Clipboard)	Копировать
Вырезать выделенный объект и поместить его в Буфер Обмена (Clipboard)	Вырезать
Найти указанный тип объекта	
Вставить из Буфера Обмена (Clipboard)	Вставить
Отменить предыдущее действие	Отмена
Повторить предыдущее отменённое действие	Повторить
Изменить размер экрана	
Изменить позицию экрана	
Свернуть окно до иконки	
Развернуть окно на полный размер	
Закрыть окно	
Восстановить окно до нормального размера	
Показать подземную карту	Подземелье
Показать проходимость объектов на карте	Проходимость
Разместить местность	Инструмент местности
Разместить реки	Инструмент рек
Разместить дороги	Инструмент дорог
Удалить объект	Ластик
Разместить объекты для грязевой местности	Объекты грязевой местности
Разместить объекты для песчаной местности	Объекты песчаной местности
Разместить объекты для травяной местности	Объекты травяной местности
Разместить объекты для снежной местности	Объекты снежной местности
Разместить объекты для болотной местности	Объекты болотной местности
Разместить объекты для каменистой местности	Объекты каменистой местности
Разместить объекты подземного мира	Объекты подземелья
Разместить объекты для лавовой местности	Объекты лавовой местности
Разместить объекты для водной местности	Объекты водной местности
Разместить города	Города
Разместить монстров	Монстры
Разместить героев	Герои
Разместить артефакты	Артефакты
Разместить сокровища	Сокровища
Анимировать объекты на карте	
Изменить спецификации карты	
Выбрать кисть местности в 1x1 сегмент	Кисть местности 1x1
Выбрать кисть местности в 2x2 сегмента	Кисть местности 2x2
Выбрать кисть местности в 4x4 сегмента	Кисть местности 4x4
Выбрать опцию "заливки" местности	Заливка
Выбрать грязевой тип местности	Грязь
Выбрать песчаный тип местности	Песок
Выбрать травяной тип местности	Трава
Выбрать снежный тип местности	Снег
Выбрать болотистый тип местности	Болото
Выбрать каменистый тип местности	Камни
Выбрать подземный тип местности	Подземелье
Выбрать лавовый тип местности	Лава
Выбрать водный тип местности	Вода
Выбрать чистый тип реки	Чистая Река
Выбрать замёрзший тип реки	Замёрзшая Река
Выбрать грязевой тип реки	Грязевая Река
Выбрать лавовый тип реки	Лавовая Река
Выбрать гравиевый тип дороги	Гравиевая дорога
Выбрать мощёный тип дороги	Мощёная дорога
Выбрать ластик в 1x1 сегмент	Ластик 1x1
Выбрать ластик в 2x2 сегмента	Ластик 2x2
Выбрать ластик в 4x4 сегмента	Ластик 4x4
Стереть область	Стереть область
Не выбирать игроков	
Выбрать игрока (%s)	
Выбрать грязевой тип дороги	Грязевая Дорога
Выбрать толщу скалы	Скала
Удалить выбранный объект	Удалить
Показать свойства выбранного объекта	Свойства
Показать сетку	Сетка
Разместить объекты для любой местности	Объекты для любой местности
Выбрать кисть в 1x1 сегмент	Кисть 1x1
Выбрать кисть в 2x2 сегмента	Кисть 2x2
Выбрать кисть в 4x4 сегмента	Кисть 4x4
Выбрать опцию "заливки"	Заливка
Проверить карту на наличие ошибок	Проверить карту
Анимировать местность	
Изменить опции применения	
Экспортировать текст из текущий карты в файл	
Импортировать текст из файла в текущую карту	
Описать выбранный объект	
Найти следующий объект заданного типа	
Найти предыдущий объект заданного типа	
Уменьшить карту	Уменьшить
Увеличить карту	Увеличить
Показать или убрать Панель Инструментов	Панель Инструментов
Показать или убрать Панель Состояния	Панель Состояния
Показать или убрать Панель Вида	Панель Вида
Автоматически разместить препятствия	Инструмент препятствий
Выбрать кисть 1х1	Кисть 1х1
Выбрать кисть 2х2	Кисть 2х2
Выбрать кисть 4х4	Кисть 4х4
Выбрать сплошную кисть	Сплошная кисть
Выбрать кисть 1х1	Размытая кисть 1х1
Выбрать кисть 2х2	Размытая кисть 2х2
Выбрать кисть 4х4	Размытая кисть 4х4
Выбрать размытую кисть	Размытая кисть
Выбрать сплошной ластик 1х1	Сплошной ластик 1х1
Выбрать сплошной ластик 2х2	Сплошной ластик 2х2
Выбрать сплошной ластик 4х4	Сплошной ластик 4х4
Выбрать сплошной ластик	Сплошной ластик
Выбрать размытый ластик 1х1	Размытый ластик 1х1
Выбрать размытый ластик 2х2	Размытый ластик 2х2
Выбрать размытый ластик 4х4	Размытый ластик 4х4
Выбрать размытый ластик	Размытый ластик
Разместить препятствия в помеченных местах	Разместить препятствия
Выбрать удаление рек	Удаление рек
Выбрать удаление дорог	Удаление дорог
Выбрать высокогорный тип местности	Высокогорье
Разместить объекты для высокогорной местности	Объекты высокогорной местности
Выбрать тип местности — пустоши	Пустоши
Разместить объекты для пустошей	Объекты пустошей
